Coflow ID,Start Time,Completion Time,Duration Time,Coflow Size,Coflow Priority
33.0,5,81900,81895,7340032.0,0
8.0,2515,45925,43410,1048576.0,0
149.0,2935,53580,50645,1048576.0,0
158.0,3385,39555,36170,4293918720.0,3
218.0,39560,55270,15710,1048576.0,0
231.0,39720,56955,17235,1048576.0,0
281.0,39830,83700,43870,50331648.0,1
322.0,39985,65640,25655,1048576.0,0
377.0,40035,67695,27660,1048576.0,0
515.0,40110,95415,55305,134217728.0,2
