Coflow ID,Start Time,Completion Time,Duration Time,Coflow Size,Coflow Priority
33.0,20,264840,264820,7340032.0,0
35.0,500,278100,277600,7340032.0,0
95.0,2040,405240,403200,7340032.0,0
122.0,3460,219200,215740,13631488.0,1
126.0,4260,306180,301920,3145728.0,0
232.0,4740,229680,224940,1048576.0,0
234.0,8920,203740,194820,20500709376.0,4
259.0,203760,337920,134160,13631488.0,1
293.0,205280,379120,173840,14680064.0,1
327.0,207720,398240,190520,26214400.0,1
